101 大床房 200 1
102 总统套房 1000 1
103 单人间 100 0
104 标准间 200 0
105 标准间 200 0
106 标准间 200 0
107 标准间 200 0
108 标准间 200 0