101 大床房 200 0
102 总统套房 1000 0
103 单人间 100 0
104 标准间 200 0
105 标准间 200 0
106 标准间 200 0
107 标准间 200 0